10, 10
0(0),     0(0),     0(0),      0(0),     0(0),     0(0),     0(0),     0(0),     0(0),     0(0),
0(0),     2(0),     0(0),      2(0),     0(0),     0(0),     0(0),     0(0),     0(0),     2(0),
0(0),     0(0),     2(0),      0(0),     0(0),     0(0),     0(0),     0(0),     0(0),     0(0),
0(0),     2(0),     0(0),    146(0),     0(0),     0(0),     0(0),     2(0),     0(0),     1(0),
0(0),     0(0),     2(0),      0(0),     0(0),     0(0),     2(0),     0(0),     2(0),     0(0),
0(0),     2(0),     0(0),      2(0),     0(0),     2(0),     0(0),     2(0),     0(8),     2(0),
0(0),     0(0),     2(0),      0(0),     2(0),     0(0),     2(0),     0(0),     2(0),     0(0),
0(0),     2(0),     0(0),      2(0),     0(0),     2(0),     0(0),     2(0),     0(0),     2(0),
0(0),     0(0),     2(0),      0(0),     0(0),     0(0),     2(0),     0(0),     2(0),     0(0),
0(0),     2(0),     0(0),      2(0),     0(0),     0(0),     0(0),     2(0),     0(0),     2(0)