10, 11
0(0),     0(0),     0(0),     0(0),     0(0),     0(0),     0(0),     0(0),     0(0),     0(0),
0(0),     0(0),     0(0),     0(0),     0(0),     0(0),     0(0),     0(0),     0(0),     0(0),
0(0),     0(0),     0(0),     0(0),     0(0),     0(0),   194(0),     0(0),     0(0),     0(0),
0(0),     0(0),     0(0),     0(0),     0(0),   130(0),     0(0),     2(0),     0(0),     0(0),
0(0),     0(0),     0(0),     0(0),   130(0),     0(0),     2(0),     0(0),     2(0),     0(0),
0(0),     0(0),     0(0),   130(0),     0(0),     2(0),     0(0),     2(0),     0(8),     2(0),
0(0),     0(0),   146(0),     0(0),     2(0),     0(0),     2(0),     0(0),     2(0),     0(0),
0(0),     0(0),     0(0),     2(0),     0(0),     2(0),     0(0),     2(0),     0(0),     2(0),
0(0),     0(0),     0(0),     0(0),     2(0),     0(0),     2(0),     0(0),     2(0),     0(0),
0(0),     0(0),     0(0),     0(0),     0(0),     2(0),     0(0),     2(0),     0(0),     0(0),
0(0),     0(0),     0(0),     0(0),     0(0),     0(0),     0(0),     0(0),     0(0),     0(0)