   20,   20
  255(   0,   0),  255(   0,   0),  255(   0,   0),  255(   0,   0),  255(   0,   0),  255(   0,   0),  255(   0,   0),  255(   0,   0),  255(   0,   0),  255(   0,   0),  255(  30,   0),  255(  31,   0),  255(   0,   0),  255(   0,   0),  255(   0,   0),  255(   0,   0),  255(   0,   0),  255(   0,   0),  255(   0,   0),  255(   0,   0),
  255(   0,   0),  255(   0,   0),  255(   0,   0),  255(   0,   0),  255(   0,   0),  255(   0,   0),  255(   0,   0),  255(  30,   0),  255(  31,   0),  255(  30,   0),  255(   0,   0),    0(   0,   0),  255(  31,   0),  255(   0,   0),  255(   0,   0),  255(   0,   0),  255(   0,   0),  255(   0,   0),  255(   0,   0),  255(   0,   0),
  255(   0,   0),  255(   0,   0),  255(   0,   0),  255(   0,   0),  255(   0,   0),  255(   0,   0),  255(  30,   0),  255(   0,   0),    0(   0,   0),  255(   0,   0),    0(   0,   0),  255(   0,   0),    0(   0,   0),  255(  31,   0),  255(   0,   0),  255(   0,   0),  255(   0,   0),  255(   0,   0),  255(   0,   0),  255(   0,   0),
  255(   0,   0),  255(   0,   0),  255(   0,   0),  255(   0,   0),  255(   0,   0),  255(  30,   0),  255(   0,   0),    0(   0,   0),  255(   0,   0),    0(   0,   0),  255(   0,   0),    0(   0,   0),  255(   0,   0),    0(   0,   0),  255(  31,   0),  255(   0,   0),  255(   0,   0),  255(   0,   0),  255(   0,   0),  255(   0,   0),
  255(   0,   0),  255(   0,   0),  255(   0,   0),  255(   0,   0),  255(  30,   0),  255(   0,   0),    0(   0,   0),  255(   0,   0),    0(   0,   0),  255(   0,   0),    0(   0,   0),  255(   0,   0),    0(   0,   0),  255(   0,   0),    0(   0,   0),  255(  31,   0),  255(   0,   0),  255(   0,   0),  255(   0,   0),  255(   0,   0),
  255(   0,   0),  255(   0,   0),  255(   0,   0),  255(  30,   0),  255(   0,   0),    0(   0,   0),  255(   0,   0),    0(   0,   0),  255(   0,   0),    0(   0,   0),  255(   0,   0),    0(   0,   0),  255(   0,   0),    0(   0,   0),  255(   0,   0),    0(   0,   0),  255(  31,   0),  255(   0,   0),  255(   0,   0),  255(   0,   0),
  255(   0,   0),  255(   0,   0),  255(  30,   0),  255(   0,   0),    0(   0,   0),  255(   0,   0),    0(   0,   0),  255(   0,   0),    0(   0,   0),  255(   0,   0),    0(   0,   0),  255(   0,   0),    0(   0,   0),  255(   0,   0),    0(   0,   0),  255(   0,   0),    0(   0,   0),  255(  31,   0),  255(   0,   0),  255(   0,   0),
  255(   0,   0),  255(   0,   0),  255(  31,   0),    0(   0,   0),  255(   0,   0),    1(   0,   0),  255(   0,   0),    0(   0,   0),  255(   0,   0),    0(   0,   0),  255(   0,   0),    0(   0,   0),  255(   0,   0),    0(   0,   0),  255(   0,   0),    0(   0,   0),  255(   0,   0),    0(   0,   0),  255(  31,   0),  255(   0,   0),
  255(   0,   0),  255(   0,   0),  255(  30,   0),  255(   0,   0),    0(   0,   0),  255(   0,   0),    0(   0,   0),  255(   0,   0),    0(   0,   0),  255(   0,   0),    0(   0,   0),  255(   0,   0),    0(   0,   0),  255(   0,   0),    0(   0,   0),  255(   0,   0),    0(   0,   0),  255(   0,   0),    0(  30,   0),  255(   0,   0),
  255(   0,   0),  255(   0,   0),  255(  31,   0),    0(   0,   0),  255(   0,   0),    1(   0,   0),  255(   0,   0),    0(   0,   0),  255(   0,   0),    0(   0,   0),  255(   0,   0),    0(   0,   0),  255(   0,   0),    0(   0,   0),  255(   0,   0),   11(   0,   0),  255(   0,   0),    0(   0,   0),  255(  31,   0),    0(   0,   0),
  255(   0,   0),  255(   0,   0),    0(   0,   0),  255(   0,   0),    0(   0,   0),  255(   0,   0),    0(   0,   0),  255(   0,   0),    0(   0,   0),  255(   0,   0),    0(   0,   0),  255(   0,   0),    0(   0,   0),  255(   0,   0),    0(   0,   0),  255(   0,   0),    0(   0,   0),  255(   0,   0),    0(  30,   0),  255(   0,   0),
  255(   0,   0),  255(   0,   0),  255(  31,   0),    0(   0,   0),  255(   0,   0),    0(   0,   0),  255(   0,   0),    0(   0,   0),  255(   0,   0),    0(   0,   0),  255(   0,   0),    0(   0,   0),  255(   0,   0),    0(   0,   0),  255(   0,   0),    0(   0,   0),  255(   0,   0),    0(   0,   0),  255(  31,   0),    0(   0,   0),
  255(   0,   0),  255(   0,   0),    0(   0,   0),  255(  31,   0),    0(   0,   0),  255(   0,   0),    0(   0,   0),  255(   0,   0),    0(   0,   0),  255(   0,   0),    0(   0,   0),  255(   0,   0),    0(   0,   0),  255(   0,   0),    0(   0,   0),  255(   0,   0),    0(   0,   0),  255(   0,   0),    0(  30,   0),  255(   0,   0),
  255(   0,   0),  255(   0,   0),  255(   0,   0),    0(   0,   0),  255(  31,   0),    0(   0,   0),  255(   0,   0),    0(   0,   0),  255(   0,   0),    0(   0,   0),  255(   0,   0),    0(   0,   0),  255(   0,   0),    0(   0,   0),  255(   0,   0),    0(   0,   0),  255(   0,   0),    0(   0,   0),  255(  31,   0),    0(   0,   0),
  255(   0,   0),  255(   0,   0),  255(   0,   0),  255(   0,   0),    0(   0,   0),  255(  31,   0),    0(   0,   0),  255(   0,   0),    0(   0,   0),  255(   0,   0),    0(   0,   0),  255(   0,   0),    0(   0,   0),  255(   0,   0),    0(   0,   0),  255(   0,   0),    0(   0,   0),  255(   0,   0),    0(  30,   0),  255(   0,   0),
  255(   0,   0),  255(   0,   0),  255(   0,   0),  255(   0,   0),  255(   0,   0),    0(   0,   0),  255(  31,   0),    0(   0,   0),  255(   0,   0),    0(   0,   0),  255(   0,   0),    0(   0,   0),  255(   0,   0),    0(   0,   0),  255(   0,   0),    0(   0,   0),  255(   0,   0),    0(  30,   0),  255(   0,   0),    0(   0,   0),
  255(   0,   0),  255(   0,   0),  255(   0,   0),  255(   0,   0),  255(   0,   0),  255(   0,   0),    0(   0,   0),  255(  31,   0),    0(   0,   0),  255(   0,   0),    0(   0,   0),  255(   0,   0),    0(   0,   0),  255(   0,   0),    0(   0,   0),  255(   0,   0),    0(  30,   0),  255(   0,   0),    0(   0,   0),  255(   0,   0),
  255(   0,   0),  255(   0,   0),  255(   0,   0),  255(   0,   0),  255(   0,   0),  255(   0,   0),  255(   0,   0),    0(   0,   0),  255(  31,   0),    0(  30,   0),  255(  31,   0),    0(  30,   0),  255(  31,   0),    0(  30,   0),  255(  31,   0),    0(  30,   0),  255(   0,   0),    0(   0,   0),  255(   0,   0),  255(   0,   0),
  255(   0,   0),  255(   0,   0),  255(   0,   0),  255(   0,   0),  255(   0,   0),  255(   0,   0),  255(   0,   0),  255(   0,   0),    0(   0,   0),  255(   0,   0),    0(   0,   0),  255(   0,   0),    0(   0,   0),  255(   0,   0),    0(   0,   0),  255(   0,   0),    0(   0,   0),  255(   0,   0),  255(   0,   0),  255(   0,   0),
  255(   0,   0),  255(   0,   0),  255(   0,   0),  255(   0,   0),  255(   0,   0),  255(   0,   0),  255(   0,   0),  255(   0,   0),  255(   0,   0),    0(   0,   0),  255(   0,   0),    0(   0,   0),  255(   0,   0),    0(   0,   0),  255(   0,   0),    0(   0,   0),  255(   0,   0),  255(   0,   0),  255(   0,   0),  255(   0,   0),
