   10,   10
  255(   0,   0),  255(   0,   0),  255(   0,   0),  255(   0,   0),  255(   0,   0),  255(   0,   0),  255(   0,   0),  255(   0,   0),  255(   0,   0),  255(   0,   0),
  255(   0,   0),  255(   0,   0),  255(   0,   0),  255(   0,   0),  255(   0,   0),  255(   0,   0),  255(   0,   0),    0(   0,   0),  255(   0,   0),    0(   0,   0),
  255(   0,   0),  255(   0,   0),  255(   0,   0),  255(   0,   0),    0(   0,   0),  255(   0,   0),    0(   0,   0),  255(   0,   0),    0(   0,   0),  255(   0,   0),
  255(   0,   0),  255(   0,   0),  255(   0,   0),    0(   0,   0),  255(   0,   0),    0(   0,   0),  255(   0,   0),    9(   0,   0),  255(   0,   0),    0(   0,   0),
  255(   0,   0),  255(   0,   0),  255(   0,   0),  255(   0,   0),    0(   0,   0),  255(   0,   0),    0(   0,   0),  255(   0,   0),    0(   0,   0),  255(   0,   0),
  255(   0,   0),  255(   0,   0),  255(   0,   0),    0(   0,   0),  255(   0,   0),    0(   0,   0),  255(   0,   0),    0(   0,   0),  255(   0,   0),    0(   0,   0),
  255(   0,   0),  255(   0,   0),  255(   0,   0),  255(   0,   0),    0(   0,   0),  255(   0,   0),    0(   0,   0),  255(   0,   0),    0(   0,   0),  255(   0,   0),
  255(   0,   0),  255(   0,   0),  255(   0,   0),    1(   0,   0),  255(   0,   0),    0(   0,   0),  255(   0,   0),    0(   0,   0),  255(   0,   0),    0(   0,   0),
  255(   0,   0),  255(   0,   0),  255(   0,   0),  255(   0,   0),    0(   0,   0),  255(   0,   0),    0(   0,   0),  255(   0,   0),    0(   0,   0),  255(   0,   0),
  255(   0,   0),  255(   0,   0),  255(   0,   0),    0(   0,   0),  255(   0,   0),    0(   0,   0),  255(   0,   0),    0(   0,   0),  255(   0,   0),    0(   0,   0),
